[level]
tileset = PathAndObjects.png
map = ############################################
      #.....#.....................#..##..##..##..#
      #.....#............###......#..##..##..##..#
      #.....####.........###......#..##..##..##..#
      #..................###......#..##..##..##..#
      ##########.........###......#..##..##..##..#
      #.....#............###......#..##..##..##..#
      #.....#............###......#..##..##..##..#
      #.....#............###......#..##..##..##..#
      #.....#............###......#..##..##..##..#
      #.....#............###......#..##..##..##..#
      #.....#............###......#..##..##..##..#
      #..................###......#..##..##..##..#
      ########...........###......#..##..##..##..#
      #......#...........###......#..##..##..##..#
      #......#....#####..###......#..##..##..##..#
      #...........#####..###......#..##..##..##..#
      #......##########..###......#..##..##..##..#
      #.....###########..###......#..##..##..##..#
      #....############..###......#..##..##..##..#
      #...#############..###......#..##..##..##..#
      #..##############..###......#..##..##..##..#
      #.###############..###......#..##..##..##..#
      ############################################

[player]
startx = 12
starty = 8

[.]
background = True
name = floor
tilex = 1
tiley = 1
passable = True

[#]
background = True
name = wall
passable = False
tilex = 2
tiley = 0
